3000000001
1101011111
0101000001
1101011101
0101000100
0120011111
0000000001
1111011101
0000010001
0111110104